сьо	sio
льо	lo
ньо	nio
цьо	cio
зьо	zio
ння	ńnia
нню	ńniu
ннє	ńnie
лля	lla
ллю	llu
ллє	lle
нь	ń
ць	ć
сь	ś
зь	ź
ль	l
лі	li
лє	le
ля	la
лю	lu
нє	nie
ня	nia
ню	niu
дє	die
дя	dia
дю	diu
зє	zie
зя	zia
зю	ziu
сє	sie
ся	sia
сю	siu
бя	bia
бю	biu
бє	bie
пя	pia
пю	piu
пє	pie
вя	wia
вю	wiu
вє	wie
мя	mia
мю	miu
мє	mie
фя	fia
фю	fiu
фє	fie
рє	r ́e
ря	r ́a
рю	r ́u
а	a
б	b
в	w
г	h
ґ	g
д	d
е	e
є	je
ж	ż
з	z
и	y
і	i
ї	ji
й	j
к	k
л	ł
м	m
н	n
о	o
п	p
р	r
с	s
т	t
у	u
ф	f
х	ch
ц	c
ч	cz
ш	sz
щ	szcz
ь	 ́
ю	ju
я	ja
'	
